Important Git Remote Commands
Below are some of the most useful Git remote commands that developers commonly use in real projects:

Remote Setup and Management                

        Command                                                     	Description
git remote add <name> <url>                          	Adds a new remote repository (e.g., origin)
git remote -v	                                        Shows all remotes and their fetch/push URLs
git remote rename <old> <new>                        	Renames an existing remote
git remote remove <name>                              Removes a remote from the local repository
git remote show <name>	                              Shows detailed info about a remote (branches, URLs, etc.)
git remote set-url <name> <new-url>	                  Updates the URL of an existing remote



                                        *** Working with Remotes ***


          Command	                                                      Description
git clone <url>	                                      Clones a remote repository to your local machine
git fetch <remote>	                                  Fetches changes from the remote without merging
git pull <remote> <branch>	                          Fetches and merges changes from a remote branch
git push <remote> <branch>	                          Pushes your local branch to a remote branch
git push --set-upstream origin <branch>	              Sets upstream for tracking and pushes branch to remote


  
                                     *** Remote Branch Handling ***

        Command	                                               Description
git branch -r	                                      Lists all remote-tracking branches
git checkout --track origin/<branch>	              Creates a local branch tracking a remote branch
git push origin --delete <branch>	                  Deletes a branch from the remote repository
git remote prune origin	                            Removes references to deleted branches from the remote

